1111111111111111111111111111111111
110000001000000C00000C00000E000001
1000010110000000101001000000010101
1010010000001010001001000000010111
1P1000001C10C0000000000000000100C1
1000000000000000000000000000000001
1111111111111111111111111111111111